EA ./textures/wall_1.xpm
SO ./textures/wall_2.xpm
C 255, 10 , 2

NO ./textures/wall_3.xpm
WE ./textures/wall_3.xpm

F 225, 30, 255

                                             
111111111111111111111111111111
111001000011111100000000000001
1000000010000000011111111111 1
1000N00001000111111111111111 1
1111111110111



