NO ./textures/wall_1.xpm
SO ./textures/barrel.xpm
C 255, 0 , 0

EA ./textures/wall_4.xpm
WE ./textures/wall_3.xpm

F 0 , 255 , 0

                                             
111111111111111111111111
100000000000000000000001
100000000000000000000001
100000000000000000000001
100000000010000000000001
100100000000001000001001
100000000000000000000001
100000000000000000010001
100000000000000000000001
10000000000W000000000001
111111111111111111111111
