EA ./textures/wall_1.xpm
SO ./textures/wall_2.xpm
C 255, 10 , 2

NO ./textures/wall_3.xpm
WE ./textures/wall_3.xpm

F 225, 30, 255

                                             
111111111111111111111111
100000000001000000000001
100000000001111000000001
100000000000001000000001
100001000000101000000001
10000000001N000000000001
100001000001000000000001
100000000000000000000001
100000000001000000000001
100000000000000000000001
111111111111111111111111


















