EA ./textures/wall_1.xpm
SO ./textures/wall_2.xpm
C 255, 10 , 2

NO ./textures/wall_3.xpm
WE ./textures/wall_3.xpm

F 225, 30, 255

                                             
111111
100001
100E01
100001
111111
















