EA ./textures/wall_1.xpm
SO ./textures/wall_2.xpm
C 255, 10 , 2

NO ./textures/wall_3.xpm
WE ./textures/wall_3.xpm

F 225, 30, 255

                                             
111111111111111111111111111111
111001000011111110000000000001
10000000100000000111111111111
1E000000100011111111     111 1
11111111111111
















